--------
-*-****-
-*-*--*-
-*-*--*-
-*-*!-*-
-*----*-
-******-
--------
<<
--------
-1-1111-
-1-1--1-
-1-1--1-
-1-10-1-
-1----1-
-111111-
--------
<<
1 1 a 1
0
a
<<
<<
<<
<<
<<
<<
b
<<
<<
<<
<<
<<
<<
<<